+-+-+-+-+-+
| | | |   |
+ + + + + +
|       | |
+ + +-+ + +
| | |     |
+ +-+-+ +-+
|   |     |
+-+ + + +-+
|   |     |
+-+-+-+-+-+
