+-+-+-+-+-+-+
| |   | |   |
+ +-+ + +-+ +
| | |       |
+ + +-+ + +-+
| |     | | |
+ + +-+ + + +
|       | | |
+-+ +-+ + + +
| |     | | |
+ + + + + + +
|   | |     |
+-+-+-+-+-+-+
