+-+-+-+-+-+-+-+-+-+-+
| | | | | |       | |
+ + + + + +-+ + +-+ +
| |             | | |
+ + + + +-+ + + + + +
| | | |   | |     | |
+ + +-+ + +-+ + + + +
|     | |     | |   |
+ + + + + + + + + + +
| | | | | | | | | | |
+-+-+-+-+-+-+-+-+-+-+
