+-+-+-+-+-+
| | | | | |
+ + + + + +
| | | | | |
+ + + + + +
|     |   |
+-+-+ + + +
|   | |   |
+ + + +-+ +
| |       |
+-+ +-+ +-+
|   |   | |
+-+ +-+ + +
| |       |
+ +-+-+-+ +
| |     | |
+ +-+ + + +
|     |   |
+-+ +-+ +-+
|         |
+-+-+-+-+-+
